XXXXXXXXXXXXXX
X    X       X
X    X       X
XXX  X   X XXX
XXX XXXXXX   X
X   X      XXX
X XXX  X     X
X X  XXX XXX X
X XX       XXX
X XXX   X    X
X XX  XX  XXXX
X    X   X   X
X XXXX X X   X
XXXXXXXXXXXXXX